02000000
01000000
01100000
00110000
00011100
00000100
00000113
00000000